R 600           400         
NO        ./textures/surfaces/dispenser_front_horizontal_dark.xpm       
SO ./textures/surfaces/furnace_top_dark.xpm 
WE ./textures/surfaces/furnace_side_dark.xpm 
EA          ./textures/surfaces/furnace_front_off_dark.xpm      
S ./textures/sprite_dead_tree.xpm

F         235 , 232     ,  210          
C 166  ,    229,        255 



   11111111111
   10000000001
   10000000001
11110000000001
10000000001111
10000000001
100N0000001
11111111111