R 1200 800
NO ./textures/surfaces/dispenser_front_horizontal_dark.xpm
EA ./textures/surfaces/furnace_front_off_dark.xpm
SO ./textures/surfaces/furnace_top_dark.xpm
WE ./textures/surfaces/furnace_side_dark.xpm
S ./textures/sprite_dead_tree.xpm
F 235,232,210
C 7,7,16
111111111111111111111111111111111
100000020111030502000000000000021
10E00000011000000300000200500011
10000020000001111111111000000311
11111111111111100001  100000011
1000030001    105001  10000201
1003000301    1000011110002001
1000111111  1110050000300002011
10001        10300000205000030111
10001        111111111000500111
10001   111111100000010000001
10031   150503000000000002001
1011111110000011100000000000111
100000020505050011111110000101
10000000000000001     111110001
1200111111111111111111100000001
10501           1000000000111111
1000111111111111100030500111111
1000002000000002000500005000001
1000000002000000000300000000001
1111111111111111111111111111111
