R 600 400
NO ./textures/dispenser_front_horizontal.xpm
SO ./textures/sandstone_normal.xpm
WE ./textures/furnace_side.xpm
EA ./textures/quartz_block_chiseled.xpm
S ./textures/Sprite-0002-clr.xpm
F 235,232,210
C 7,7,16
1111111111111111111
1000000000000000001
1000000020000000001
1000000000000000001
1000000000000000001
1111110000000020001
     1000000000000111111
    110020001101100000001
    1000000010001000000001
    1000000000N00000000001
    110000001000100000001
     1000000110110111111
1111110000000000001
1000000000000000001
1000000000000000001
1000000000000000001
1000000000000000001
1000000000000000001
1000111111111110001
11011         11111
 101
 111