R 600 400
NO ./textures/surfaces/dispenser_front_horizontal_dark.xpm
SO ./textures/surfaces/furnace_top_dark.xpm
WE ./textures/surfaces/furnace_side_dark.xpm
EA ./textures/surfaces/furnace_front_off_dark.xpm
S ./textures/sprite_dead_tree.xpm
F 235,232,210
C 7,7,16
111111111111111111111111111111111111
100000000000000000000000000000000001
100500000000300000000000000000000001
100000002001111111111111100000030001
1000000000N1    100001  100000000001
100000000001    100001  100000000001
100005000001    10000111100000000001
100000011111    10000000000000000001
10000001        10000000000000030001
10000001        11111111100000000001
10000001   1111111      100000000001
10000001   1000001      100000000001
100500011111000001      100000000001
100000002000000001      100000030001
100000000000000001      100000000001
111111111111111111      100000000001
1000000000001           100000000001
100000000000111111111111000000000001
100000000000000000000000000000000001
100000000000000000000000000000000001
111111111111111111111111111111111111
