R 600 400
NO ./textures/surfaces/dispenser_front_horizontal_dark.xpm
SO ./textures/surfaces/furnace_top_dark.xpm
WE ./textures/surfaces/furnace_side_dark.xpm
EA ./textures/surfaces/furnace_front_off_dark.xpm
S ./textures/sprite_dead_tree.xpm
F 235,232,210
C 7,7,16
1111111111111111111
1000000000000000001
1050000000003000001
1000000020000003001
1000000000002000001
1111110000000000001
     1000000000000111111
    110000001111100000001
    100000001   1000000000
    100020001   1000000001
    110000001   100000001
     1000000111110111111
1111110000000000001
1000000000000000001
1000300000000000001
1000000000N00000001
1000000000000050001
1000000000000000001
1000111111111110001
11011         11111
 101
 111