R 600 400
NO ./textures/dispenser_front_horizontal.xpm
SO ./textures/sandstone_normal.xpm
WE ./textures/furnace_side.xpm
EA ./textures/quartz_block_chiseled.xpm
S ./textures/sapling_oak.xpm
F 235,232,210
C 166,229,255
        1111111111111111111111111
        1000000000110000000000001
        1011000001110000002000001
        1001000000000000000000001
111111111011000001110000000000001
100000000011000001110111110111111
11110111111111011100000010001
11110111111111011101010010201
11000000110101011100000010001
10002000000000001100000010001
10000000000000001101010010001
11000001110101011111011110N0111
11110111 1110101 101111010001
11111111 1111111 111111111111