R 600 400
NO ./textures/dispenser_front_horizontal.xpm
SO ./textures/sandstone_normal.xpm
WE ./textures/furnace_side.xpm
EA ./textures/quartz_block_chiseled.xpm
S ./textures/sapling_oak.xpm
F 235,232,210
C 166,229,255
1111111
1000001
1002001
1000001
100N001
1000001
1111111