1111111111111111111
1000000000000000001
1000000000000000001
1000000000000000001
1000000000000000001
1111110000000000001
     1000000000000111111
    110000001101100000001
    1000000010001000000001
    1000000000N00000000001
    110000001000100000001
     1000000110110111111
1111110000000000001
1000000000000000001
1000000000000000001
1000000000000000001
1000000000000000001
1000000000000000001
1000111111111110001
11011         11111
 101
 111