 111111
11000011
1000N001
11000011
 111111