111111111111111111111111
1S1000110000010001000111
101010110111010101010111
100010110001010111010111
110110110111110000010111
100000110010000111110111
101111111010111100000111
100010001010110001110111
101010101010111011110101
101000101000101010110001
101111111010101010111111
101000000010001000000111
101011011111111111110111
101001010000000000010111
101101010111111111010111
100001000100000000010001
111111111111111111111101