R 600 400
NO ./textures/surfaces/texture1.xpm
EA ./textures/surfaces/texture2.xpm
SO ./textures/surfaces/texture3.xpm
WE ./textures/surfaces/texture4.xpm
S ./textures/sprite_dead_tree.xpm
F 255,255,255
C 0,0,0
111111111111111111111111
1S1000110000010001000101
101010110111010101010101
100010110001010111010101
110110110111110000010101
100000110010000111110101
101111111010111100000101
100010001010110001110101
101010101010111011110101
101000101000101010110001
101111111010101010111111
101000000010001000000101
101011011111111111110101
101001010000000000010101
101101010111111111010101
101101010100000021010101
101101010101111111010101
100001000101000000010001
111111110101111111111101
100000000100000000000001
111111111111111111111111