R 600 400
NO ./textures/surfaces/texture1.xpm
EA ./textures/surfaces/texture2.xpm
SO ./textures/surfaces/texture3.xpm
WE ./textures/surfaces/texture4.xpm
S ./textures/sprite_dead_tree.xpm
F 255,255,255
C 0,0,0

111111111111111111111111111111111111111111111111
122211000000111100000000001100000011000000110011
120211000000111100000000001100000011000000110011
12N211001100111100111111001100110011001100110011
120211001100111100111111001100110011001100110011
100000001100111100000011001100111111001100110011
100000001100111100000011001100111111001100110011
111100111100111100111111111100000000001100110011
111100111100111100111111111100000000001100110011
110000000000111100001100000000111111111100110011
110000000000111100001100000000111111111100110011
110011111111111111001100111111110000000000110011
110011111111111111001100111111110000000000110011
110000001100000011001100111100000011111100110011
110000001100000011001100111100000011111100110011
110011001100110011001100111111001111111100110011
110011000000110011000000110011001100111100000011
110011000000110011000000110011001100111100000011
110011111111111111001100110011001100111111111111
110011000000000000001100000011000000000000111111
110011000000000000001100000011000000000000111111
110011001111001111111111111111111111111100111111
110011001111001100000000000000000000001100111111
110011000011001100000000000000000000001100111111
110011000011001100111111111111111111001100111111
110011110011001100110000000000000011001100111111
110011110011001100110000000000000011001100111111
110011110011001100110000000002000011001100111111
110011110011001100110000000000000011001100111111
110011110011001100110000000000000011001100111111
110000000011000000110011111111111111001100000011
110000000011000000110010000000000000001100000011
111111111111111111110010000000000000001111110011
111111111111111111110011111111111111111111110011
111111111111111111110000000000000000000000000011
111111111111111111110000000000000000000000000011
111111111111111111111111111111111111111111111111

