R 600000 400000
NO ./textures/surfaces/texture1.xpm
EA ./textures/surfaces/texture2.xpm
SO ./textures/surfaces/texture3.xpm
WE ./textures/surfaces/texture4.xpm
S ./textures/sprite_dead_tree.xpm
F 255,255,255
C 0,0,0
1111111
1000001
1010001
1000001
1000101
100N001
1111111